+-+---+-+-+-+-+-+-+-+-+-+-+-+-+-+-+-+-+-+-+-+-+-+-+-+-+-+
|<|   | | | | | | | | | | | | | | | | | | | | | | | | | |
| | | | +-+-+-+-+-+-+-+-+-+-+-+-+-+-+-+-+-+-+-+-+-+-+-+-+
| | |^   M M   #        | | | | | | | | | | | | | | | | |
| +-+ | +-+-+-+-+-+-+-+ +-+-+-+-+-+-+-+-+-+-+-+-+-+-+-+-+
|M #  | |M          | | | | | | | | | | | | | | | | | | |
| +---+ + +-+-+-+-+ +-+ +-+-+-+-+-+-+-+-+-+-+-+-+-+-+-+-+
|#|  S  |          ^|   | |   | | | | | | | | | | | | | |
| | --+-+ +-+-+-+ +-+ + +-+ + +-+-+-+-+-+-+-+-+-+-+-+-+-+
|  ^  | |#|     |  S  |S| |S|                      S  | |
+-+-+-+ + + +-+-+-+-+-+ +-+ +-+-+-+-+-+-+-+-+-+-+-+-+ +-+
| |M                         ^ ^     ^   ^ ^ ^   ^      |
+-+-+-+-+-+-+-+-+-+-+-+ +-+-+-+-+-+-+-+-+-+-+-+-+-+-+-+ +
| | | | | | | | | | | | | | | | | | | | | | | | | | | |>|
+-+-+-+-+-+-+-+-+-+-+-+-+-+-+-+-+-+-+-+-+-+-+-+-+-+-+-+-+
